NO ./textures/eagle.xpm
SO ./textures/eagle.xpm
WE ./textures/eagle.xpm
EA ./textures/eagle.xpm

F 120,32,32          
C 120,120,255

        1111111111111111111111111
        1000000000110000000000001
        10110000011100000010000011
        10010000000000100000000001
1111111110110000011100000000000011
100000000011000001110111111111111
11110111111111011100000010001
11110111111111011101100100011
11000000110101011110000000001
10001010000000000110000001001
10000000000000011010100100011
1111101111010E11111111100011
1 101111 1111111011 10100011
1 11111 1111111111111111111
1
1
111
